1111111111111111111..11111111111
111C..................1....C1111
1.....1........M...11..........1
1.....................1........1
1....1............1........1...1
1.......11..1........111.......1
1...1...1..M...........1.......1
1.......1...1..1.......1.......1
1...C...1.......1..............1
1...1...1.........1....1....M..1
1.......1...........1..........1
1.......1......11.....11.1.....1
1....1.........11......1..M1...1
1..................1...1.......1
1...C...1.....N........1.....1.1
1.......1.....11.......1.......1
1.1.....1..............1....1..1
1.....N.1..................1...1
1.....1111...1......1..111.....1
1.............1...1............1
1..............1..........1....1
1....1..........11....1........1
1111.....C.......1..1..1C1.P..11
11111111111111111111111111111111
LLLLLLLLLLLLLLLLLLLLLLLLLLLLLLLL